#######################################
# Syntax Coloring Map
#######################################
#######################################
# # Datatypes (KEYWORD1)
#######################################
FLProgAbstractWiFiClient	KEYWORD1
FLProgAbstractWiFiUDP	KEYWORD1
FLProgAbstracttWiFiInterface	KEYWORD1
FLProgOnBoardWifi	KEYWORD1
FLProgWiFiClient	KEYWORD1
FLProgWiFiUDP	KEYWORD1
FlprogAbstractWiFiServer	KEYWORD1
FlprogWiFiServer	KEYWORD1

#######################################
# Methods and Functions (KEYWORD2)
#######################################
accept	KEYWORD2
apDns	KEYWORD2
apGateway	KEYWORD2
apLocalIP	KEYWORD2
apMac	KEYWORD2
apMode	KEYWORD2
apOff	KEYWORD2
apOn	KEYWORD2
apSubnet	KEYWORD2
available	KEYWORD2
begin	KEYWORD2
beginMulticast	KEYWORD2
beginPacket	KEYWORD2
beginPacketMulticast	KEYWORD2
bool	KEYWORD2
canStartServer	KEYWORD2
clientMode	KEYWORD2
clientOff	KEYWORD2
clientOn	KEYWORD2
close	KEYWORD2
connect	KEYWORD2
connected	KEYWORD2
destinationIP	KEYWORD2
dhcpMode	KEYWORD2
dns	KEYWORD2
end	KEYWORD2
endPacket	KEYWORD2
flush	KEYWORD2
gateway	KEYWORD2
getNoDelay	KEYWORD2
hasClient	KEYWORD2
isBusy	KEYWORD2
isImitation	KEYWORD2
isReady	KEYWORD2
listening	KEYWORD2
localIP	KEYWORD2
localPort	KEYWORD2
mac	KEYWORD2
parsePacket	KEYWORD2
peek	KEYWORD2
pool	KEYWORD2
read	KEYWORD2
remoteIP	KEYWORD2
remotePort	KEYWORD2
resetBusy	KEYWORD2
resetDhcp	KEYWORD2
setApPassword	KEYWORD2
setApSsid	KEYWORD2
setBusy	KEYWORD2
setClientPassword	KEYWORD2
setClientSsidd	KEYWORD2
setDhcp	KEYWORD2
setNoDelay	KEYWORD2
stop	KEYWORD2
stopAll	KEYWORD2
subnet	KEYWORD2
write	KEYWORD2

#######################################
# Constants (LITERAL1)
#######################################
ARDUINO_ARCH_ESP32	LITERAL1
ARDUINO_ARCH_ESP8266	LITERAL1
ARDUINO_ARCH_RP2040	LITERAL1
ARDUINO_RASPBERRY_PI_PICO_W	LITERAL1
FLPROG_WIFI_TCP_CLIENT	LITERAL1
FLPROG_WIFI_TCP_DEVICE	LITERAL1